1111111111111111111111111111111111
1000000000000000000000000000000001
1010100000000010100000011100000001
100E00000000010001000000C100000001
1010100000000010100000011100000001
1000000000000000000000000000001001
1001000000000000000000000000001101
10011000000100000100000000000C0001
1000000000000101000000001010000001
10000C0000001101100000001010000001
10001110000000P0000000001C10000001
100C100000001101100000001010000001
1000100000000101000000001010000001
1000000000010000010000000000000001
1000000000000000000100000100000001
100000000000000000010111010001C001
1000001100000000000101C10100011001
1000001100000000000101010100000001
1000000000000000000100000100000001
1111111111111111111111111111111111