11111111111111111
11000000P00000011
10000000000000001
11100110C01100111
100CC0001000CC001
100CC0X010X0CC001
11100110C01100111
10000000000000001
11000000E00000011
11111111111111111