111111111111111
1p000001000c001
100101000111001
100c10ce0101c01
100101000111001
11c0000c0000001
111111111111111